Name	Class	Distinguished Name
OU=Accounting	organizationalUnit	OU=Accounting,DC=joboptionsinc,DC=org
CN=Builtin	builtinDomain	CN=Builtin,DC=joboptionsinc,DC=org
OU=Cloud_Members	organizationalUnit	OU=Cloud_Members,DC=joboptionsinc,DC=org
OU=CM	organizationalUnit	OU=CM,DC=joboptionsinc,DC=org
OU=Commissary	organizationalUnit	OU=Commissary,DC=joboptionsinc,DC=org
CN=Computers	container	CN=Computers,DC=joboptionsinc,DC=org
OU=Domain Controllers	organizationalUnit	OU=Domain Controllers,DC=joboptionsinc,DC=org
OU=EVS	organizationalUnit	OU=EVS,DC=joboptionsinc,DC=org
OU=Facilities	organizationalUnit	OU=Facilities,DC=joboptionsinc,DC=org
OU=Facilities-JanLan	organizationalUnit	OU=Facilities-JanLan,DC=joboptionsinc,DC=org
OU=Food Services	organizationalUnit	OU=Food Services,DC=joboptionsinc,DC=org
CN=ForeignSecurityPrincipals	container	CN=ForeignSecurityPrincipals,DC=joboptionsinc,DC=org
OU=HP 2300B	organizationalUnit	OU=HP 2300B,DC=joboptionsinc,DC=org
OU=HR	organizationalUnit	OU=HR,DC=joboptionsinc,DC=org
CN=Hybrid	group	CN=Hybrid,DC=joboptionsinc,DC=org
OU=ISO	organizationalUnit	OU=ISO,DC=joboptionsinc,DC=org
OU=JOI Corporate	organizationalUnit	OU=JOI Corporate,DC=joboptionsinc,DC=org
OU=JOIT	organizationalUnit	OU=JOIT,DC=joboptionsinc,DC=org
OU=Laundry Division	organizationalUnit	OU=Laundry Division,DC=joboptionsinc,DC=org
CN=LostAndFound	lostAndFound	CN=LostAndFound,DC=joboptionsinc,DC=org
OU=Low Bandwith to WWW	organizationalUnit	OU=Low Bandwith to WWW,DC=joboptionsinc,DC=org
CN=Managed Service Accounts	container	CN=Managed Service Accounts,DC=joboptionsinc,DC=org
OU=Microsoft Exchange Security Groups	organizationalUnit	OU=Microsoft Exchange Security Groups,DC=joboptionsinc,DC=org
CN=Microsoft Exchange System Objects	msExchSystemObjectsContainer	CN=Microsoft Exchange System Objects,DC=joboptionsinc,DC=org
CN=NTDS Quotas	msDS-QuotaContainer	CN=NTDS Quotas,DC=joboptionsinc,DC=org
OU=Otay Mesa	organizationalUnit	OU=Otay Mesa,DC=joboptionsinc,DC=org
OU=pm	organizationalUnit	OU=pm,DC=joboptionsinc,DC=org
CN=Program Data	container	CN=Program Data,DC=joboptionsinc,DC=org
OU=PTS	organizationalUnit	OU=PTS,DC=joboptionsinc,DC=org
OU=Roaming computers	organizationalUnit	OU=Roaming computers,DC=joboptionsinc,DC=org
OU=Sales and Marketing	organizationalUnit	OU=Sales and Marketing,DC=joboptionsinc,DC=org
CN=System	container	CN=System,DC=joboptionsinc,DC=org
CN=TPM Devices	msTPM-InformationObjectsContainer	CN=TPM Devices,DC=joboptionsinc,DC=org
CN=Users	container	CN=Users,DC=joboptionsinc,DC=org
CN=Infrastructure	infrastructureUpdate	CN=Infrastructure,DC=joboptionsinc,DC=org
